11111111111
1111111PCE1
11111111111
