111111111
1E000N001
1P000N001
1C0000N01
111111111
