1111111111111111111111111
10000000000N0000P0C001001
10000000N00000000N0000001
11011N11C1000000000000011
1000E10000N000000000000C1
1000000000000000000000001
1000000000000000000000111
10000000000000000000000N1
1111111111111111111111111