111111111111
100P0C001001
100000N00001
10001000C001
100NEN0N00C1
111111111111