111111111111
100P0C001001
10N000000001
11011111C111
1000E10000C1
111111111111
