111111111
1E0000001
1P0000001
1C0000N01
111111111
