1111111111111111111111111
10000000000N0000P0C001001
10000000N00000000N0000001
11011N11C1000000000000011
1000E10000N000000000000C1
1111111111111111111111111
