11111111111111111111
10000000000000000001
10000000000000000001
10010000000000001001
10010000000000001001
10000C00000C00100101
10010000000000001001
10010000000000001001
1PE11111111111110001
11111111111111111111
