111111
100001
10P101
10C001
111111
