1111111111
1000000011
10P0000111
1000C000E1
1111111111
