1111111111
1000E00011
10P0000111
1000C00011
1111111111
