111111
10E011
10P1C1
1010E1
111111
