1111111111111111111111111111111111111
100000000000000000000C000000000000001
100000000P0000011111000110000000E0001
1000000000000000001100011000000000001
1000000000000011111111111000000000001
1000000000000011001100000000000000001
1000000000C000110011110000C00000000C1
100000000000000000000C000000000000001
1111111111111111111111111111111111111
