1111111111111111111111111111111111111
100000000000000000000C000000N00000001
10000N000P000001111100011000N00NE0001
1000000000000000001100011000000000001
10000000N0000011111111111000N00000001
1000000000000011001100000000000000001
1000000000C000110011110000C00000000C1
10000N000N000000N0000C00000N00000N001
1111111111111111111111111111111111111
